00000000000000000000
00000000000000000000
00000000000000000000
00000000000000000000
00000000000000000000
00000000000000000000
00000000000000000000
00000000000000000000
00000000000000000000
00000000000000000000
00000000000000000000
00000000000000000000
00000011000000000000
00000110000000000000
11111100000000000000
11111000000000000000
11110000000000000000
11100000000000000000
11000000000000000000
10000000000000000000
