00000000000000000000
00000000000000000000
00000000000000000000
00000000000000000000
00000000000000000000
00000000000000000000
00000000000000000000
00000000000000000000
00000000000000000000
11111111111111111111
11000000000000000000
11000000000000000000
11000000000000000000
11000000000000000000
11000000000000000000
11000000000000000000
11000000000000000000
11000000000000000000
11000000000000000000
10000000000000000000
